11111111
10YY0CE1
1P000001
10X00CE1
11111111