11111111
10000CE1
1P000001
10000CE1
11111111