11111111111111111111111111111111
111110PC000000000000000000000111
1000000CCCCC00000111111111111111
1110000000010000000CCCCCCCCCCE11
11111111111111111111111111111111